11111111111111111111111111
1E000000000000C0000X000001
10000110C010000X0000011001
10X00111111010100000000001
1000000C00000000000000C001
11111111111111111111111111