000000P0000000000000
00000000000000000000
000C0000000000C00000
0E0000000000000C0000
00000000000000000000