111111111111111111111
1C0000CCCC0000000001
1000101000000001C01
 1P01E100000000CC1
     11111111111