11111111111111111111111111
1E000000000000000000000001
100001100010000000000110P1
10000111111010100000000001
10000000000000000000000001
11111111111111111111111111