11111111111111111111111111
1E000000000000C00000000001
10000110C010000000000110P1
100001111110101000X0000001
10X0000C00000000000000C001
11111111111111111111111111