11111111111111111111111111
1E000000000000C00000000001
10000110C0100X000000011001
100001111110111000X0000001
10X0010C00000000000000C001
100000000XX0000000000X0001
10X00111000000011000000001
10000000000C0000000000P001
11111111111111111111111111