1111111111111111111111111111111111
1E000000000000C0000000000000000001
10000110C01000000011100000E0011001
10000111111010100010C0000000000001
1P00000C00000000E0000000000000C001
1111111111111111111111111111111111
