11111111111111111111111111
1E000000C00000000000000001
1000110C01000011100E001101
1001111010100010C000000001
1P000000E0000000000000C001
1001111010100010C000000001
1P000000E0000000000000C001
11111111111111111111111111