/* mapas buenos */

1111111111111
10010000000C1
1000011111001
1P0011E000001
1111111111111


1111111111111111111111111111111111
1E0000000000000C00000C000000000001
1010010100100000101001000000010101
1010010010101010001001000000010101
1P0000000C00C0000000000000000000C1
1111111111111111111111111111111111


111111111111111111111111111111111111111111111111111111111111
1C0000CCCC000000000C000000C111111100000000CCC0000C0000000C11
1000101000000001C001100001000000000000100000000001C110000111
100010100100000100011C00010000000111000100100000011111000001
1P001E100000000CCC01000C000011C11CCCC11CCCCC1110000000000001
1C0000CCCC010000000C000000011111110000000000C0110C0001000C11
1000101000000001C0011000010000000000001C00000001101110000111
1C0000C1CC010100000C0000100110C11100000000CC10000C0000000011
1000101000010011C00110000100000000000010000011000110100C0001
1C00C00CCC0000C1000C00C0000111111100000000C0C0000C0000000011
1000101000110001C00110000100001C000000100C00011100111001C111
111111111111111111111111111111111111111111111111111111111111

/* MAPAS MALOS */

111111111111111111111
1C0000CCCC000000000C1
1000101000000001C0011
1P001E100000000CCCC01
111111111111111111111

111111111111111111111
100000P0000000000000
100C0000000000C000001
1E0000000000000C00001
111111111111111111111

1111111111111111111111111111111111
1E1000000000000C00000C000000000001
1110010100100000101001000000010101
1010010010101010001001000000010101
1P0000000C00C0000000000000000000C1
1111111111111111111111111111111111

------

1111111111111111111111111111111111
1E0000000000000C00000C000000000001
1010010100100000101001000000010101

1010010010101010001001000000010101
1P0000000C00C0000000000000000000C1
1111111111111111111111111111111111

-----------------------

1111111111111111111111111111111111
100000000000000C00000C000000000001
1010010100100000101001000000010101
1010010010101010001001000000010101
1P0000000C00C0000000000000000000C1
1111111111111111111111111111111111

1111111111111111111111111111111111
1E0000000000000C00000C0000000000E1
1010010100100000101001000000010101
1010010010101010001001000000010101
1P0000000C00C0000000000000000000C1
1111111111111111111111111111111111

1111111111111111111111111111111111
1E0000000000000C00000C000000000001
1010010100100000101001000000010101
1P10010010101010001001000000010101
1P0000000C00C0000000000000000000C1
1111111111111111111111111111111111

1111111111111111111111111111111111
1E00000000000000000000000000000001
1010010100100000101001000000010101
1010010010101010001001000000010101
1P00000000000000000000000000000001
1111111111111111111111111111111111

/* MAP BONUS */

1111111111111
10010000000C1
10X00111110X1
1P0011E000001
1111111111111

111111111111111111111
1C0000CCCC0X0000000C1
1X0X1010X0000X01C0X11
1P001E10000X000CCCC01
111111111111111111111